NO textures/north.xpm
SO textures/south.xpm
WE textures/west.xpm
EA textures/east.xpm

F 58,	42,    31
C 29,21,16

11111111111
1       D 1
1   D     1
1         1
1       N 1
11111111111

