NO textures/north.xpm
SO textures/south.xpm
WE textures/west.xpm
EA textures/east.xpm

F 58,	42,    31
C 29,21,16

111111111111111111111
1010000010001D1000001
101010101011101110001
100010100010000010001
111110101111101011101
100000101000101000001
1D1000000000000000001
101111101011101111111
101000001010100000101
101011111010111110101
101010001010100010101
101110101010101010101
100000101010001010001
111111101011111011101
100000101000100010001
101110101110101110111
101000100000100011101
101010111111111010101
100010000D00000010001
101010111011111111111
1N10100000D0000000001
111111111111111111111

