NO textures/north.xpm
SO textures/south.xpm
WE textures/west.xpm
EA textures/east.xpm

F 58,42,31
C 29,21,16

111111111
10100000111111111111111111111111111111111111
101000001
11100000111111111111111111111111111111111111111111111111111111111111111111111111111111111111111111111111111111111111111111111111111111
10000N00000000000000000000000000000000000000000000000000000000000000000000000000000000000000000000000000000000000000000000000000100001
11111011111111111111111111111111111111111111111111111111111111111111111111111111111111111111111111111111111111111111111111111111111111
10011100111111111111111111
10000000111111111111111111
111111111
