NO sprites/north
SO sprites/south
WE sprites/west
EA sprites/east

F 58,42,31
C 29,21,16

111111111111111
111111   111111
11111     11111
1111  N    1111
111         111
11           11
1    11111    1
11    111    11
111    1    111
1111       1111
11111     11111
111111   111111
111111111111111
