NO textures/north.xpm
SO textures/south.xpm
WE textures/west.xpm
EA textures/east.xpm

F 204,	0,    200
C 255,255,255

11111111111D111111111
101000001000000000001
101010101011111111111
100010100010000010001
111110101111101011101
100000101000101000001
100000000000000000001
101111101011101111111
101000001010100000101
101011111010111110101
101010001010100010101
101110101010101010101
100000101010001010001
111111101011111011101
100000101000100010001
101110101110101110111
101000100000100011101
101011111111111010101
100010000000000010001
101010111011111111101
1N1000001000000000001
111111111111111111111
