NO textures/north.xpm
SO textures/south.xpm
WE textures/west.xpm
EA textures/east.xpm
F 204,	0,    200
C 255,255,255

11111111111111111111
01000001000000000001
01010101011111110001
00010100010000010001
11110101111101011101
00000101000101000001
00000000000000000001
01111101011101111111
01000001010100000101
01011111010111110101
01010001010100010101
01110101010101010101
00000101010001010001
11111101011111011101
00000101000100010001
01110101110101110111
01000100000100011101
01011111111111010101
00010000000000010001
01010111011111111101
N1000001000000000001
11111111111111111111
