NO textures/north.xpm
SO textures/south.xpm
WE textures/west.xpm
EA textures/east.xpm
F 204,	0,    200
C 255,255,255

   1                
   1              
1111             
           N
               
                 
                 
